
||||||||||||||||||||||||||||
|..........................|
|.|||||||||||..|||||||||||.|
|.|||||||||||..|||||||||||.|
|..........................|
|.||||.||.|||..|||.||.||||.|
|.||||.||.|||..|||.||.||||.|
|.||||.||.|||..|||.||.||||.|
|.||||.||.|||..|||.||.||||.|
|.........|||..|||.........|
|.||.||||.|||..|||.||||.||.|
|.||.||||..........||||.||.|
|.||......||||||||......||.|
|.||.||||.||||||||.||||.||.|
|.||.||||.||||||||.||||.||.|
|.||.||||.||||||||.||||.||.|
|.||.||||.||||||||.||||.||.|
|..........................|
|.||||||||.||||||.||||||||.|
|.||||||||.||||||.||||||||.|
|..........||||||..........|
|.||.|||||.||||||.|||||.||.|
|.||.|||||.||..||.|||||.||.|
|.||....................||.|
|.||.||||||.||||.||||||.||.|
|.||.||||||.||||.||||||.||.|
|..........................|
|.||||||.||||||||||.||||||.|
|.||||||.||||||||||.||||||.|
|..........................|
||||||||||||||||||||||||||||
