
||||||||||||||||||||||||||||
|..........................|
|.||.|||||||.||.|||||||.||.|
|.||.|||||||.||.|||||||.||.|
|............||............|
|.|||.||||||.||.||||||.|||.|
|.|||.||||||.||.||||||.|||.|
|.|||.||.....||.....||.|||.|
|.|||.||.|||.||.|||.||.|||.|
|.|||.||.|||.||.|||.||.|||.|
|.|||.||.|||.||.|||.||.|||.|
|..........................|
|.|||||||.||||||||.|||||||.|
|.|||||||.||||||||.|||||||.|
|.||||....||||||||....||||.|
|.||||.||.||||||||.||.||||.|
|.||||.||.||||||||.||.||||.|
|..........................|
|.||||..||||.||.||||..||||.|
|.||||.|||||.||.|||||.||||.|
|.||||.|||||.||.|||||.||||.|
|.||||.||||......||||.||||.|
|.|||.......||||.......|||.|
|.|||.|||.||||||||.|||.|||.|
|.|||.|||.|||..|||.|||.|||.|
|......||.|||..|||.||......|
|.||||.||.|||..|||.||.||||.|
|.||||.||.|||..|||.||.||||.|
|.||||.||.|||..|||.||.||||.|
|..........................|
||||||||||||||||||||||||||||
