
||||||||||||||||||||||||||||
|..........................|
|.|||||.||||||||||||.|||||.|
|.|||||.||||||||||||.|||||.|
|.|||||.||||||||||||.|||||.|
|..........................|
|.||||.|||.||||||.|||.||||.|
|.||||.|||.||||||.|||.||||.|
|.||||.|||..||||..|||.||||.|
|......||||.||||.||||......|
|.||||.||||.||||.||||.||||.|
|.||||.||..........||.||||.|
|.||||....||||||||....||||.|
|.||||.||.||||||||.||.||||.|
|.||||.||.||||||||.||.||||.|
|.||||.||.||||||||.||.||||.|
|.........||||||||.........|
|.|||||..............|||||.|
|.|||||.|||.||||.|||.|||||.|
|.|||||.|||.||||.|||.|||||.|
|.|||||.|||.||||.|||.|||||.|
|.......|||.||||.|||.......|
|.||.||..............||.||.|
|.||.||.|||.||||.|||.||.||.|
|.||.||.|||.||||.|||.||.||.|
|.||.||.|||..||..|||.||.||.|
|.||.||.||||.||.||||.||.||.|
|.||.||.||||.||.||||.||.||.|
|.||.||.||||.||.||||.||.||.|
|..........................|
||||||||||||||||||||||||||||
