
||||||||||||||||||||||||||||
|..........................|
|.||.||.||||||||||||.||.||.|
|.||.||.||||||||||||.||.||.|
|.||.||.||||||||||||.||.||.|
|.||.||..............||.||.|
|.||.||.||||||||||||.||.||.|
|.||.||.||||||||||||.||.||.|
|....||..............||....|
|.||....||.||||||.||....||.|
|.|||.||||.||||||.||||.|||.|
|.|||.|||..........|||.|||.|
|.|||.|||.||||||||.|||.|||.|
|.....|||.||||||||.|||.....|
|.|||.|||.||||||||.|||.|||.|
|.|||.|||.||||||||.|||.|||.|
|.........||||||||.........|
|.|||||||..........|||||||.|
|.|||||||..||||||..|||||||.|
|..........||||||..........|
|.||||||||........||||||||.|
|.||||||||.||||||.||||||||.|
|..........||||||..........|
|.||||||||.||||||.||||||||.|
|.||||||||.||||||.||||||||.|
|.......||........||.......|
|.|||||.||.||||||.||.|||||.|
|.|||||.||.||||||.||.|||||.|
|.|||||.||.||||||.||.|||||.|
|..........................|
||||||||||||||||||||||||||||
