
||||||||||||||||||||||||||||
|..........................|
|.||.||||.||||||||.||||.||.|
|.||.||||.||||||||.||||.||.|
|.||.||||.||||||||.||||.||.|
|.||.||||..........||||.||.|
|.........|||..|||.........|
|.||.||||||||..||||||||.||.|
|.||.||||||||..||||||||.||.|
|.||......|||..|||......||.|
|.||.||||.|||..|||.||||.||.|
|.||.||||..........||||.||.|
|.||.||||.||||||||.||||.||.|
|....||||.||||||||.||||....|
|.||......||||||||......||.|
|.|||||||.||||||||.|||||||.|
|.|||||||.||||||||.|||||||.|
|.||||||............||||||.|
|........||||..||||........|
|.||||||.||||..||||.||||||.|
|.||||||.||||..||||.||||||.|
|.||||||.||||..||||.||||||.|
|.||||||............||||||.|
|.........|||..|||.........|
|.||||.||.|||..|||.||.||||.|
|.||||.||..||..||..||.||||.|
|.||||.|||.||..||.|||.||||.|
|.||||.|||.||..||.|||.||||.|
|.||||.|||.||..||.|||.||||.|
|..........................|
||||||||||||||||||||||||||||
