
||||||||||||||||||||||||||||
|..........................|
|.|||.||||||.||.||||||.|||.|
|.|||.||||||.||.||||||.|||.|
|.........||.||.||.........|
|.|||||||.||.||.||.|||||||.|
|.|||||||.||.||.||.|||||||.|
|.|||||||.||.||.||.|||||||.|
|............||............|
|.||.||...||.||.||...||.||.|
|.||.||||.||.||.||.||||.||.|
|....||||..........||||....|
|.|||||||.||||||||.|||||||.|
|.|||||||.||||||||.|||||||.|
|.........||||||||.........|
|.||.||||.||||||||.||||.||.|
|.||.||||.||||||||.||||.||.|
|....||||..........||||....|
|.||.|||||||.||.|||||||.||.|
|.||.|||||||.||.|||||||.||.|
|.||.........||.........||.|
|.|||.||.|||.||.|||.||.|||.|
|.|||.||.|||.||.|||.||.|||.|
|.....||.|||.||.|||.||.....|
|.|||.||.....||.....||.|||.|
|.|||.||.|||.||.|||.||.|||.|
|.|||.||.|||.||.|||.||.|||.|
|.|||.||.|||.||.|||.||.|||.|
|.|||.||.|||.||.|||.||.|||.|
|..........................|
||||||||||||||||||||||||||||
