
||||||||||||||||||||||||||||
|..........................|
|.||||.||.||||||||.||.||||.|
|.||||.||.||||||||.||.||||.|
|......||.||||||||.||......|
|.||||.||.||||||||.||.||||.|
|.||||.||..........||.||||.|
|.||||.||.||||||||.||.||||.|
|.||||....||||||||....||||.|
|.||||.||.||||||||.||.||||.|
|.||||.||.||||||||.||.||||.|
|..........................|
|.|||||||.||||||||.|||||||.|
|.|||||||.||||||||.|||||||.|
|.|||||||.||||||||.|||||||.|
|.|||||||.||||||||.|||||||.|
|.........||||||||.........|
|.||.||||..........||||.||.|
|.||.||||.|||..|||.||||.||.|
|.||.||...|||..|||...||.||.|
|.||.||.|||||..|||||.||.||.|
|.||.||.|||||..|||||.||.||.|
|.||.||..............||.||.|
|.......||.||..||.||.......|
|.|||||.||.||..||.||.|||||.|
|.|||||.||.||..||.||.|||||.|
|.|||||.||.||..||.||.|||||.|
|.|||||.||.||||||.||.|||||.|
|.|||||.||.||||||.||.|||||.|
|..........................|
||||||||||||||||||||||||||||
