
||||||||||||||||||||||||||||
|..........................|
|.||||||.||||||||||.||||||.|
|.||||||.||||||||||.||||||.|
|............||............|
|.||||.|||||.||.|||||.||||.|
|.||||.|||||.||.|||||.||||.|
|.||||.||....||....||.||||.|
|.|||.....||.||.||.....|||.|
|.....||||||.||.||||||.....|
|.|||.||||||.||.||||||.|||.|
|.|||..................|||.|
|.|||||||.||||||||.|||||||.|
|.|||||||.||||||||.|||||||.|
|.........||||||||.........|
|.|||.|||.||||||||.|||.|||.|
|.|||.|||.||||||||.|||.|||.|
|.|||.|||..........|||.|||.|
|.|||.||||.||..||.||||.|||.|
|.|||.||||.||..||.||||.|||.|
|..........||..||..........|
|.||||.|||.||..||.|||.||||.|
|.||||.|||.||||||.|||.||||.|
|.||||.|||.||||||.|||.||||.|
|..........................|
|.|||.|||||.||||.|||||.|||.|
|.|||.|||||.||||.|||||.|||.|
|.|||.|||||.||||.|||||.|||.|
|.|||.|||||.||||.|||||.|||.|
|..........................|
||||||||||||||||||||||||||||
