
||||||||||||||||||||||||||||
|..........................|
|.|||||||.||||||||.|||||||.|
|.|||||||.||||||||.|||||||.|
|.........||||||||.........|
|.|||||||.||||||||.|||||||.|
|.|||||||..........|||||||.|
|.........||||||||.........|
|.|||||.||||||||||||.|||||.|
|.|||||.||||||||||||.|||||.|
|.|||||.||||||||||||.|||||.|
|..........................|
|.|||.|||.||||||||.|||.|||.|
|.|||.|||.||||||||.|||.|||.|
|.|||.|||.||||||||.|||.|||.|
|.|||.|||.||||||||.|||.|||.|
|.|||.....||||||||.....|||.|
|.....|||..........|||.....|
|.|||||||||.||||.|||||||||.|
|.|||||||||.||||.|||||||||.|
|.....||....||||....||.....|
|.|||.||.||.||||.||.||.|||.|
|.|||.||.||.||||.||.||.|||.|
|.|||..................|||.|
|.|||.||||||||||||||||.|||.|
|.|||.||||||||||||||||.|||.|
|.|||...||........||...|||.|
|.|||||.||.||||||.||.|||||.|
|.|||||.||.||||||.||.|||||.|
|..........................|
||||||||||||||||||||||||||||
