
||||||||||||||||||||||||||||
|..........................|
|.|||||.||.||||||.||.|||||.|
|.|||||.||.||||||.||.|||||.|
|.......||..||||..||.......|
|.|||||||||.||||.|||||||||.|
|.|||||||||.||||.|||||||||.|
|..........................|
|.||||||.||||..||||.||||||.|
|.||||||.||||..||||.||||||.|
|.||||||.||||..||||.||||||.|
|..........................|
|.|||.|||.||||||||.|||.|||.|
|.|||.|||.||||||||.|||.|||.|
|.|||.|||.||||||||.|||.|||.|
|.....|||.||||||||.|||.....|
|.|||.....||||||||.....|||.|
|.|||.|||..........|||.|||.|
|.|||.||||.||||||.||||.|||.|
|.|||.||||.||||||.||||.|||.|
|..........||||||..........|
|.||||||.||||||||||.||||||.|
|.||||||.||......||.||||||.|
|.....||....||||....||.....|
|.|||.||.||.||||.||.||.|||.|
|.|||.||.||.||||.||.||.|||.|
|.|||.||.||.||||.||.||.|||.|
|.|||.||.||.||||.||.||.|||.|
|.|||.||.||.||||.||.||.|||.|
|..........................|
||||||||||||||||||||||||||||
