
||||||||||||||||||||||||||||
|..........................|
|.|||||||.||.||.||.|||||||.|
|.|||||||.||.||.||.|||||||.|
|....||||.||.||.||.||||....|
|.||......||.||.||......||.|
|.||||.||.||.||.||.||.||||.|
|.||||.||.||.||.||.||.||||.|
|.||||.||.||....||.||.||||.|
|.||||.||.||||||||.||.||||.|
|.||||.||.||||||||.||.||||.|
|.||||.||..........||.||||.|
|......||.||||||||.||......|
|.||||.||.||||||||.||.||||.|
|.||||.||.||||||||.||.||||.|
|.||||.||.||||||||.||.||||.|
|.........||||||||.........|
|.|||.|||..........|||.|||.|
|.|||.|||.||.||.||.|||.|||.|
|.|||.||..||.||.||..||.|||.|
|.|||.||.||......||.||.|||.|
|.....||.||||||||||.||.....|
|.||......||||||||......||.|
|.||.||||.||||||||.||||.||.|
|.||.||||.||||||||.||||.||.|
|.||.||||..........||||.||.|
|.||......||||||||......||.|
|.||.||||.||||||||.||||.||.|
|.||.||||.||||||||.||||.||.|
|..........................|
||||||||||||||||||||||||||||
