
||||||||||||||||||||||||||||
|..........................|
|.||||||.||.||||.||.||||||.|
|.||||||.||.||||.||.||||||.|
|.||||||.||.||||.||.||||||.|
|.||||||.||.||||.||.||||||.|
|........||......||........|
|.|||.||.||||..||||.||.|||.|
|.|||.||.||||..||||.||.|||.|
|.|||.||.||||..||||.||.|||.|
|.|||.||.||||..||||.||.|||.|
|..........................|
|.|||||||.||||||||.|||||||.|
|.|||||||.||||||||.|||||||.|
|.|||||||.||||||||.|||||||.|
|.........||||||||.........|
|.|||.|||.||||||||.|||.|||.|
|.|||.|||..........|||.|||.|
|.|||.||....||||....||.|||.|
|.|||.||.||.||||.||.||.|||.|
|.....||.||.||||.||.||.....|
|.|||.||.||.||||.||.||.|||.|
|.|||.||.||.||||.||.||.|||.|
|.|||.......||||.......|||.|
|.|||||.|||......|||.|||||.|
|....||.||||.||.||||.||....|
|.||....||||.||.||||....||.|
|.|||||.||||.||.||||.|||||.|
|.|||||.||||.||.||||.|||||.|
|..........................|
||||||||||||||||||||||||||||
