
||||||||||||||||||||||||||||
|..........................|
|.|||.||.||||||||||.||.|||.|
|.|||.||.||||||||||.||.|||.|
|.|||.||............||.|||.|
|.|||.||||||||||||||||.|||.|
|.|||.||||||||||||||||.|||.|
|.|||..................|||.|
|.|||.|||.||||||||.|||.|||.|
|.|||.|||.||||||||.|||.|||.|
|.........||||||||.........|
|.|||||||..........|||||||.|
|.|||||||.||||||||.|||||||.|
|.||||....||||||||....||||.|
|......||.||||||||.||......|
|.|||||||.||||||||.|||||||.|
|.|||||||.||||||||.|||||||.|
|..........................|
|.||||||.|||.||.|||.||||||.|
|.||||||.|||.||.|||.||||||.|
|.||.........||.........||.|
|.||.||.||||.||.||||.||.||.|
|.||.||.||||.||.||||.||.||.|
|.||.||.||||.||.||||.||.||.|
|....||.||||.||.||||.||....|
|.||.||..............||.||.|
|.||.||.||||||||||||.||.||.|
|.||.||.||||||||||||.||.||.|
|.||.||.||||||||||||.||.||.|
|..........................|
||||||||||||||||||||||||||||
