
||||||||||||||||||||||||||||
|..........................|
|.||||||.||||||||||.||||||.|
|.||||||.||||||||||.||||||.|
|........||......||........|
|.||||.||||.||||.||||.||||.|
|.||||.||||.||||.||||.||||.|
|.||||.|||........|||.||||.|
|.||||.....||||||.....||||.|
|.|||||.||.||||||.||.|||||.|
|.|||||.||.||||||.||.|||||.|
|..........................|
|.|||.|||.||||||||.|||.|||.|
|.|||.|||.||||||||.|||.|||.|
|.|||.|||.||||||||.|||.|||.|
|.|||.|||.||||||||.|||.|||.|
|.....|||.||||||||.|||.....|
|.|||.|||..........|||.|||.|
|.|||......||..||......|||.|
|.||||.|||.||..||.|||.||||.|
|.||||.|||.||..||.|||.||||.|
|..........||..||..........|
|.|||.||||.||..||.||||.|||.|
|.|||.||||.||..||.||||.|||.|
|.....||||.||..||.||||.....|
|.|||.||||........||||.|||.|
|.|||.||||.||||||.||||.|||.|
|.|||.||||.||||||.||||.|||.|
|.|||.||||.||||||.||||.|||.|
|..........................|
||||||||||||||||||||||||||||
