
||||||||||||||||||||||||||||
|..........................|
|.||.||||.||||||||.||||.||.|
|.||.||||.||||||||.||||.||.|
|.||........||||........||.|
|.||..|||||.||||.|||||..||.|
|.|||.|||||.||||.|||||.|||.|
|.|||..................|||.|
|.....||||||.||.||||||.....|
|.||..||||||.||.||||||..||.|
|.||....||||.||.||||....||.|
|.||.||..............||.||.|
|.||.||||.||||||||.||||.||.|
|.||.||||.||||||||.||||.||.|
|.||.||||.||||||||.||||.||.|
|.........||||||||.........|
|.|||||||.||||||||.|||||||.|
|.|||||||..........|||||||.|
|..........||..||..........|
|.||.|||||.||..||.|||||.||.|
|.||.|||||.||..||.|||||.||.|
|.||.|||||.||||||.|||||.||.|
|.||..||||.||||||.||||..||.|
|.|||..................|||.|
|.|||.|||||||..|||||||.|||.|
|.....|||||||..|||||||.....|
|.|||..................|||.|
|.|||||.||||||||||||.|||||.|
|.|||||.||||||||||||.|||||.|
|..........................|
||||||||||||||||||||||||||||
