
||||||||||||||||||||||||||||
|..........................|
|.||.|||||.||..||.|||||.||.|
|.||.|||||.||..||.|||||.||.|
|.||.|||||.||..||.|||||.||.|
|.||.......||..||.......||.|
|.||.|||||.||..||.|||||.||.|
|.||.|||||.||..||.|||||.||.|
|.||.|||||.||..||.|||||.||.|
|.||.|||||.||..||.|||||.||.|
|..........||..||..........|
|.||||.||..........||.||||.|
|.||||.||.||||||||.||.||||.|
|.||||.||.||||||||.||.||||.|
|......||.||||||||.||......|
|.|||||||.||||||||.|||||||.|
|.|||||||.||||||||.|||||||.|
|..........................|
|.||.|||.||||||||||.|||.||.|
|.||.|||.||||||||||.|||.||.|
|.||.|||.||||||||||.|||.||.|
|.||.|||.||||||||||.|||.||.|
|.||..||............||..||.|
|.|||.||.||||||||||.||.|||.|
|.|||.||.||||||||||.||.|||.|
|.|||..................|||.|
|......||.||||||||.||......|
|.|||||||.||||||||.|||||||.|
|.|||||||.||||||||.|||||||.|
|..........................|
||||||||||||||||||||||||||||
