
||||||||||||||||||||||||||||
|..........................|
|.||.||.||||||||||||.||.||.|
|.||.||.||||||||||||.||.||.|
|.||.||.||||||||||||.||.||.|
|.||....||||||||||||....||.|
|.|||||..............|||||.|
|.|||||.|||||..|||||.|||||.|
|.||....|||||..|||||....||.|
|.||.||||||||..||||||||.||.|
|.||.||||||||..||||||||.||.|
|.||....................||.|
|....||||.||||||||.||||....|
|.||.||||.||||||||.||||.||.|
|.||.||||.||||||||.||||.||.|
|.||.||||.||||||||.||||.||.|
|.||.||||.||||||||.||||.||.|
|..........................|
|.||||.|||.||..||.|||.||||.|
|.||||.|||.||..||.|||.||||.|
|.||||.|||.||..||.|||.||||.|
|.||||.....||..||.....||||.|
|......|||.||..||.|||......|
|.||||.|||.||..||.|||.||||.|
|.||||..||.||..||.||..||||.|
|.|||||.||........||.|||||.|
|....||.||.||||||.||.||....|
|.||.||.||.||||||.||.||.||.|
|.||.||.||.||||||.||.||.||.|
|..........................|
||||||||||||||||||||||||||||
