
||||||||||||||||||||||||||||
|..........................|
|.||.|||||||.||.|||||||.||.|
|.||.|||||||.||.|||||||.||.|
|.||.|||..||.||.||..|||.||.|
|.||.|||..||.||.||..|||.||.|
|.||.........||.........||.|
|.||.|||||.||||||.|||||.||.|
|.||.|||||.||||||.|||||.||.|
|......|||.||||||.|||......|
|.||||.|||.||||||.|||.||||.|
|.||||................||||.|
|.||||.||.||||||||.||.||||.|
|......||.||||||||.||......|
|.|||||||.||||||||.|||||||.|
|.|||||||.||||||||.|||||||.|
|.........||||||||.........|
|.||.||||..........||||.||.|
|.||.||||.||.||.||.||||.||.|
|.||.||...||.||.||...||.||.|
|.||.||.||||.||.||||.||.||.|
|.||.||.||||.||.||||.||.||.|
|.||.||.||||.||.||||.||.||.|
|.||.||.||||.||.||||.||.||.|
|.||.||.||||.||.||||.||.||.|
|.||.||..............||.||.|
|.......||||.||.||||.......|
|.||||||||||.||.||||||||||.|
|.||||||||||.||.||||||||||.|
|..........................|
||||||||||||||||||||||||||||
