
||||||||||||||||||||||||||||
|..........................|
|.|||.|||||||..|||||||.|||.|
|.|||.|||||||..|||||||.|||.|
|.....|||..........|||.....|
|.|||.|||.||||||||.|||.|||.|
|.|||.|||.||||||||.|||.|||.|
|.|||.|||.||||||||.|||.|||.|
|.|||..................|||.|
|.....||||||.||.||||||.....|
|.|||.||||||.||.||||||.|||.|
|.|||..................|||.|
|.|||.|||.||||||||.|||.|||.|
|.|||.|||.||||||||.|||.|||.|
|.........||||||||.........|
|.||||.||.||||||||.||.||||.|
|.||||.||.||||||||.||.||||.|
|.||||.||..........||.||||.|
|.||||....||||||||....||||.|
|......||.||||||||.||......|
|.|||.|||.||....||.|||.|||.|
|.|||.|||....||....|||.|||.|
|.....|||.||.||.||.|||.....|
|.|||.|||.||.||.||.|||.|||.|
|.|||.....||.||.||.....|||.|
|.|||.|||.||.||.||.|||.|||.|
|.|||.|||.||.||.||.|||.|||.|
|.|||.|||.||.||.||.|||.|||.|
|.|||.|||.||.||.||.|||.|||.|
|..........................|
||||||||||||||||||||||||||||
