
||||||||||||||||||||||||||||
|..........................|
|.||||.||||||||||||||.||||.|
|.||||.||||||||||||||.||||.|
|.||||................||||.|
|......|||.||||||.|||......|
|.||.|||||.||||||.|||||.||.|
|.||.|||....||||....|||.||.|
|.||.|||.||.||||.||.|||.||.|
|.||.....||.||||.||.....||.|
|.||.||||||.||||.||||||.||.|
|.||.||||..........||||.||.|
|.........||||||||.........|
|.|||||||.||||||||.|||||||.|
|.|||||||.||||||||.|||||||.|
|.|||||||.||||||||.|||||||.|
|....||||.||||||||.||||....|
|.||....................||.|
|.||.||||||.||||.||||||.||.|
|.||.||||||.||||.||||||.||.|
|.||.||||||.||||.||||||.||.|
|.||.|||....||||....|||.||.|
|.||.|||.||.||||.||.|||.||.|
|........||......||........|
|.||||||.||.||||.||.||||||.|
|.||||||.||.||||.||.||||||.|
|.||||||.||.||||.||.||||||.|
|.||||||.||.||||.||.||||||.|
|.||||||.||.||||.||.||||||.|
|..........................|
||||||||||||||||||||||||||||
