
||||||||||||||||||||||||||||
|..........................|
|.||||.||||||||||||||.||||.|
|.||||.||||||||||||||.||||.|
|.||||.||||||||||||||.||||.|
|.||||................||||.|
|.||||.||||||||||||||.||||.|
|.||||.||||||||||||||.||||.|
|.........||....||.........|
|.||.||||.||.||.||.||||.||.|
|.||.||||.||.||.||.||||.||.|
|.||.||||..........||||.||.|
|.||.||||.||||||||.||||.||.|
|.||.||||.||||||||.||||.||.|
|.||......||||||||......||.|
|....||||.||||||||.||||....|
|.||.||||.||||||||.||||.||.|
|.||.||||..........||||.||.|
|.||.||||.||||||||.||||.||.|
|.||.||||.||||||||.||||.||.|
|.||.|||............|||.||.|
|.||.|||.||||||||||.|||.||.|
|........||||||||||........|
|.||||||............||||||.|
|.||||||.|||.||.|||.||||||.|
|.||||...|||.||.|||...||||.|
|.||||.|||||.||.|||||.||||.|
|.||||.|||||.||.|||||.||||.|
|.||||.|||||.||.|||||.||||.|
|..........................|
||||||||||||||||||||||||||||
