
||||||||||||||||||||||||||||
|..........................|
|.||||||||.||||||.||||||||.|
|.||||||||.||||||.||||||||.|
|.......||.||||||.||.......|
|.|||||.||.||||||.||.|||||.|
|.|||||.||........||.|||||.|
|..........||||||..........|
|.|||||||.||||||||.|||||||.|
|.|||||||.||||||||.|||||||.|
|.........||||||||.........|
|.|||||||..........|||||||.|
|.|||||||.||||||||.|||||||.|
|.........||||||||.........|
|.||.||||.||||||||.||||.||.|
|.||.||||.||||||||.||||.||.|
|....||||.||||||||.||||....|
|.||||................||||.|
|.||||.|||||.||.|||||.||||.|
|......|||||.||.|||||......|
|.||||.|||||.||.|||||.||||.|
|.||||.......||.......||||.|
|.||||.||.||.||.||.||.||||.|
|.||||.||.||.||.||.||.||||.|
|......||.||.||.||.||......|
|.||||.||..........||.||||.|
|.||||.||.||||||||.||.||||.|
|.||||.||.||||||||.||.||||.|
|.||||.||.||||||||.||.||||.|
|..........................|
||||||||||||||||||||||||||||
