
||||||||||||||||||||||||||||
|..........................|
|.||||.||||||||||||||.||||.|
|.||||.||||||||||||||.||||.|
|.||||................||||.|
|.||||.||||.||||.||||.||||.|
|.||||.||||.||||.||||.||||.|
|.||||.||||..||..||||.||||.|
|.......||||.||.||||.......|
|.||.||...||.||.||...||.||.|
|.||.||||.||.||.||.||||.||.|
|.||.||||..........||||.||.|
|.||.||||.||||||||.||||.||.|
|.........||||||||.........|
|.||||.||.||||||||.||.||||.|
|.||||.||.||||||||.||.||||.|
|.||||.||.||||||||.||.||||.|
|.||||.||..........||.||||.|
|..........||||||..........|
|.|||||.||.||||||.||.|||||.|
|.|||||.||.||||||.||.|||||.|
|.|||||.||........||.|||||.|
|..........||..||..........|
|.||||||||.||..||.||||||||.|
|.||||||||.||..||.||||||||.|
|..........||||||..........|
|.|||.||||.||||||.||||.|||.|
|.|||.||||.||||||.||||.|||.|
|.|||.||||.||||||.||||.|||.|
|..........................|
||||||||||||||||||||||||||||
