
||||||||||||||||||||||||||||
|..........................|
|.||||||.||||..||||.||||||.|
|.||||||.||||..||||.||||||.|
|.||||||.||||..||||.||||||.|
|.||||||.||||..||||.||||||.|
|..........||..||..........|
|.||||||||.||..||.||||||||.|
|.||||||||.||..||.||||||||.|
|.||||..||.||..||.||..||||.|
|.......||.||..||.||.......|
|.||.||..............||.||.|
|.||.||||.||||||||.||||.||.|
|.||.||||.||||||||.||||.||.|
|.||.||||.||||||||.||||.||.|
|.||.||||.||||||||.||||.||.|
|.||.||||.||||||||.||||.||.|
|....||..............||....|
|.||....|||.||||.|||....||.|
|.|||.|||||.||||.|||||.|||.|
|.|||.|||||.||||.|||||.|||.|
|.|||.|||||.||||.|||||.|||.|
|.|||.|||..........|||.|||.|
|.||......||||||||......||.|
|.||.||||.||||||||.||||.||.|
|.||.||||.||....||.||||.||.|
|.||...||....||....||...||.|
|.||||.||.||||||||.||.||||.|
|.||||.||.||||||||.||.||||.|
|..........................|
||||||||||||||||||||||||||||
